##############
#            #
## ### ##### #
#    # #     #
#    # #  ####
#    # #     S
######E#######